11111111111111111111111111
1C00000000000000C00000C0E1
1C000000P0000000C00000C0E1
1C00000000000000C00000C0E1
11111111111111111111111111
